11111111
1E0P1001
11111101
10100101
1100C001
11111111