11111111
1E0P0001
10111101
10100101
10000001
11111111