11111111
1E000001
10100001
10100101
1P0000C1
11111111