11111111
1E0P0001
10100101
10000101
11110C01
11111110