11111111
1ECP1001
11111101
10100101
11000001
11111111