11111111111111111111111111111111111111111
11111011111011111011111111111111111111111
11111011111011111011111111111111111111111
10000PCCCCCCCCCCCCCCCCCCCCCCCCCCCCCCCCCE1
11011111011111011111111111111111111111111
10011111011111011111111111111111111111111
11111111111111111111111111111111111111111
